11111111111111111111111111
1E011CC11CC011000000000001
100110000CC011000000000001
10000001111011000011111111
100110011CC011000011111111
1P011001111011000011111111
100110001C0000000011111111
11111110111111111111111111
11111110111111111111111111
11111110111111111111111111
11111110111111111111111111
11111110111111111111111111
11111110111111111111111111
11111110111111111111111111
11111110111111111111111111
11111110111111111111111111
11111110111111111111111111
11111110111111111111111111
11111110111111111111111111
10011CC01CC011000000000001
100110000CC011000000000001
10000001111011000011111111
100110011CC011000011111111
10011001111011000011111111
100110011C0000000011111111
11111111111111111111111111
11111111111111111111111111
11111111111111111111111111
11111111111111111111111111
11111111111111111111111111
11111111111111111111111111
11111111111111111111111111
11111111111111111111111111
11111111111111111111111111
11111111111111111111111111
11111111111111111111111111
11111111111111111111111111