1111111111111111
1P00000C00001111
1C000111100011C1
11000W0000W000V1
1110V0110000EC01
111110C1CW00C001
1111111111111111