1111111111111111111111
1000000C000011100V0001
10000111100011C0010001
1100000000W01111110001
1110001100000000000001
1000001C00000000W00001
10CW001W000P0000VEC001
10V0000000000000VC0001
1000001000000000000001
1010011100100111111001
1010C11110101111111001
1000000000000000000001
1111111111111111111111