1111111111111111111111111111111111111111111
1E011C011CC011CCC01C010110000000000000000P1
10011C011CC01100CC0000011000000000000000001
1001100111101100000000011011111111111111111
100110011CC011000000000110000000000000000C1
1101100111101100000000011011111111111111111
1C0110011CC011000000000110000000000000000C1
1101100111101100000000011011111111111111111
1001100111101111100111111011111111111111111
1000000000000000000000000000000000000000001
1111111100000000000000000000000011111111111
10CCC001000CCCCC00C0000CCCC000001000CCCC001
10CC001100000C000C0C00000C0000001100CCCC001
10C0011100000C00CCCCC000C000000011100CCC001
1000111100000C0C00000C0CCCC00000111100CC001
100111110000000000000000000000001111100C001
1011111100000000000000000000000011111100001
1C000000000000000000000000000000000000000C1
1111111111111111111111111111111111111111111