1111111111
1P00000001
1C00000101
10000001E1
1111111111