111111111111111
10C000000000C01
1CC001C00000001
111EP1000000001
1100000000C1001
111111111111111